Area_name,Deaths,Deaths_2020,Deaths_2021,March_2020,April_2020,May_2020,June_2020,July_2020,August_2020,September_2020,October_2020,November_2020,December_2020,January_2021,February_2021,March_2021,April _2021,LA_code,Shareddwelling,Unshareddwelling,totalDwelling,Fulltime,Parttime,Economicallyactive,EconomicallyInactive,Total Eco,young_age,Middle_Age,Old_age,total age_count,Badhealth,Goodhealth,TotalHealth,Total_population
Adur,87,43,44,0,22,15,0,0,0,3,2,0,1,29,13,2,0,E07000223,6,27647,27653,16445,7034,31054,12806,67339,6487,16917,6680,30084,2757,22373,25130,150206
Allerdale,259,101,158,1,42,15,4,4,8,0,2,12,13,72,76,9,1,E07000026,3,45430,45433,25912,11615,48904,22074,108505,9429,26990,10747,47166,4762,33297,38059,239163
Amber Valley,306,168,138,4,54,25,11,2,1,1,6,34,30,74,51,12,1,E07000032,3,54930,54933,36229,13374,63280,27278,140161,12974,35777,12430,61181,5810,42795,48605,304880
Arun,320,90,230,1,31,25,7,0,0,1,2,6,17,132,80,15,3,E07000224,75,70115,70190,37607,15734,71573,34498,159412,14070,37605,19002,70677,6608,54975,61583,361862
Ashfield,378,205,173,1,71,51,10,5,0,1,7,32,27,68,72,29,4,E07000170,10,52786,52796,34795,12976,59970,28067,135808,14144,34475,11472,60091,6764,41200,47964,296659
Ashford,347,202,145,1,48,40,41,22,4,5,2,3,36,93,38,13,1,E07000105,21,49726,49747,33223,12334,61189,23063,129809,12966,33578,10772,57316,4163,41385,45548,282420
Aylesbury Vale,356,161,195,1,82,30,6,5,3,0,1,14,19,96,78,19,2,E07000004,22,71861,71883,54696,17751,95242,31498,199187,20453,52760,14088,87301,4661,59530,64191,422562
Babergh,204,121,83,2,33,17,6,0,0,0,2,31,30,58,18,6,1,E07000200,5,39010,39015,23434,9578,44347,18728,96087,7866,24286,9936,42088,3023,31433,34456,211646
Barking and Dagenham,513,274,239,15,119,20,4,0,0,4,6,41,65,161,66,9,3,E09000002,59,71020,71079,44490,15608,86404,41164,187666,30086,50345,9221,89652,8686,62720,71406,419803
Barnet,867,516,351,46,321,55,6,2,1,2,5,27,51,246,81,20,4,E09000003,256,139090,139346,93174,30478,184483,73960,382095,61365,98228,23472,183065,12197,117508,129705,834211
Barnsley,717,503,214,1,111,80,30,6,0,2,28,135,110,98,76,32,8,E08000016,49,104926,104975,62841,24807,113306,57099,258053,27158,66833,21925,115916,15278,77649,92927,571871
Barrow-in-Furness,165,124,41,3,56,9,1,3,2,1,10,29,10,22,13,5,1,E07000027,7,33011,33018,18723,8470,33897,17206,78296,7503,19523,7192,34218,4542,22865,27407,172939
Basildon,555,299,256,1,126,48,17,12,0,0,13,29,53,162,64,26,4,E07000066,3,74029,74032,50693,17855,89570,36225,194343,22449,49696,14421,86566,7355,60991,68346,423287
Basingstoke and Deane,287,152,135,4,66,23,15,0,0,0,0,22,22,86,33,13,3,E07000084,12,70924,70936,59049,16506,94800,28443,198798,22348,51107,13375,86830,4559,58917,63476,420040
Bassetlaw,214,158,56,0,32,16,16,3,1,2,6,30,52,28,16,7,5,E07000171,9,49392,49401,31585,12752,56556,26749,127642,11359,32046,11463,54868,5912,39138,45050,276961
Bath and North East Somerset,265,118,147,8,62,12,3,2,0,0,2,4,25,58,82,7,0,E06000022,110,75821,75931,46367,18818,89752,40798,195735,19282,46581,15807,81670,5831,58849,64680,418016
Bedford,479,238,241,12,69,51,17,13,3,2,3,23,45,122,102,13,4,E06000055,88,67245,67333,45943,15841,81782,31982,175548,20292,43973,12649,76914,5596,56663,62259,382054
Bexley,579,302,277,9,149,38,11,7,4,2,7,33,42,176,80,16,5,E09000004,37,95000,95037,66838,23072,118864,47050,255824,28475,66071,18624,113170,8688,80446,89134,553165
Birmingham,2716,1645,1071,41,831,201,47,11,8,29,68,197,212,522,422,96,31,E08000025,524,423109,423633,251668,96186,488221,272031,1108106,163025,267415,69471,499911,54105,363904,418009,2449659
Blaby,208,115,93,2,28,28,11,3,0,3,2,20,18,44,35,13,1,E07000129,2,39667,39669,29207,10733,50661,17897,108498,10126,27645,9062,46833,3081,33631,36712,231712
Blackburn with Darwen,416,242,174,0,52,26,4,4,9,6,20,65,56,105,55,12,2,E06000008,30,59585,59615,35597,14535,67033,37384,154549,20753,39547,10238,70538,8428,49010,57438,342140
Blackpool,382,249,133,0,56,40,20,7,1,1,19,58,47,76,42,15,0,E06000009,132,68852,68984,34230,14836,68540,35273,152879,16120,38628,13971,68719,10346,48022,58368,348950
Bolsover,222,106,116,2,25,19,2,1,0,1,2,32,22,54,42,17,3,E07000033,1,34362,34363,21542,7986,37442,18503,85473,8673,22006,7483,38162,5152,25423,30575,188573
Bolton,680,495,185,5,194,72,15,7,4,6,43,83,66,84,70,25,6,E08000001,54,120748,120802,74631,27798,134933,65790,303152,35414,77070,23424,135908,14465,93765,108230,668092
Boston,157,120,37,0,22,8,3,0,0,0,0,22,65,23,7,5,2,E07000136,9,28336,28345,18683,7480,33031,14275,73469,8116,16799,6717,31632,3058,24225,27283,160729
Bournemouth,376,124,252,1,46,19,4,2,0,0,5,21,26,134,103,15,0,E06000028,374,85007,85381,51149,18289,96017,41557,207012,28906,46927,14457,90290,8009,63260,71269,453952
Bracknell Forest,157,80,77,3,40,13,7,0,0,1,3,7,6,46,25,5,1,E06000036,14,46923,46937,40762,11066,65137,17979,134944,15742,35173,7476,58391,2859,38814,41673,281945
Bradford,1162,854,308,1,265,140,47,11,9,20,62,167,132,132,106,41,29,E08000032,234,207034,207268,125745,52795,243727,122490,544757,75286,136649,35120,247055,23768,186031,209799,1208879
Braintree,402,134,268,1,65,33,7,4,0,0,3,11,10,156,91,19,2,E07000067,10,62694,62704,43859,15747,78715,28003,166324,17042,42618,12944,72604,5046,52492,57538,359170
Breckland,295,111,184,1,42,35,6,2,0,0,1,4,20,115,60,7,2,E07000143,5,57420,57425,36350,13772,65029,29147,144298,13621,33966,14697,62284,5623,48663,54286,318293
Brent,792,516,276,41,344,52,12,5,1,4,9,10,38,169,82,17,8,E09000005,335,111748,112083,83772,25702,163991,69735,343200,64631,84669,17756,167056,12339,108169,120508,742847
Brentwood,224,137,87,2,56,19,5,2,0,0,5,21,27,60,24,3,0,E07000068,8,32059,32067,21677,7142,38149,14810,81778,8035,21621,6842,36498,2306,24537,26843,177186
Brighton and Hove,405,193,212,2,86,43,11,4,2,0,7,13,25,114,77,21,0,E06000043,515,123902,124417,75999,27492,150853,59939,314283,44526,79050,17278,140854,11151,91970,103121,682675
Bristol,565,346,219,9,155,49,17,4,0,2,10,45,55,102,93,18,6,E06000023,458,187980,188438,127829,42980,227119,94387,492315,76513,108362,27426,212301,18056,143283,161339,1054393
Broadland,309,93,216,0,30,28,5,2,0,0,3,7,18,101,103,11,1,E07000144,6,54854,54860,34180,15110,64232,26073,139595,11352,35221,14342,60915,4499,46106,50605,305975
Bromley,673,357,316,19,215,67,9,3,0,2,5,9,28,193,110,11,2,E09000006,113,134923,135036,91506,29012,161282,61257,343057,38802,91791,25649,156242,9904,105574,115478,749813
Bromsgrove,247,156,91,4,78,37,9,0,0,0,0,6,22,50,33,5,3,E07000234,3,39371,39374,26705,10393,48664,19143,104905,8218,26942,9760,44920,3484,31306,34790,223989
Broxbourne,215,106,109,2,58,10,1,1,1,0,5,8,20,82,21,5,1,E07000095,7,39185,39192,27083,9790,49426,18173,104472,11739,27044,8030,46813,3357,33072,36429,226906
Broxtowe,261,161,100,4,51,26,5,4,0,0,5,27,39,43,43,7,7,E07000172,8,48658,48666,33191,11855,56838,24735,126619,13074,31397,10663,55134,4521,38276,42797,273216
Burnley,290,173,117,0,35,17,5,2,2,6,20,44,42,79,28,10,0,E07000117,10,39929,39939,23187,9129,41879,21497,95692,11050,23530,7525,42105,5213,29286,34499,212235
Bury,519,393,126,7,128,46,35,6,2,3,35,75,56,60,33,28,5,E08000002,9,81414,81423,53953,19118,94680,40007,207758,23004,52910,16148,92062,8539,61634,70173,451416
Calderdale,318,221,97,2,77,22,5,6,5,4,18,47,35,43,41,12,1,E08000033,40,92133,92173,57617,21923,104893,43873,228306,24430,59542,17488,101460,8929,70007,78936,500875
Cambridge,121,78,43,1,49,26,1,0,0,0,1,0,0,21,17,4,1,E07000008,92,48196,48288,37350,10001,62886,35397,145634,22519,28562,6784,57865,3533,39600,43133,294920
Camden,308,173,135,6,126,17,5,2,0,1,2,2,12,76,44,11,4,E09000007,701,99127,99828,66955,13727,118397,55436,254515,49271,58726,12809,120806,9174,67334,76508,551657
Cannock Chase,265,147,118,4,42,18,6,1,0,2,5,29,40,71,39,6,2,E07000192,4,41812,41816,28840,11009,51306,20968,112123,11856,28733,8830,49419,5121,34133,39254,242612
Canterbury,451,213,238,0,57,35,17,11,3,0,2,12,76,179,47,9,3,E07000106,59,63800,63859,34938,14268,71322,40545,161073,15331,35390,14183,64904,6133,52338,58471,348307
Carlisle,319,166,153,10,59,44,5,6,5,2,5,15,15,95,50,7,1,E07000028,53,50177,50230,31161,13295,57210,22321,123987,12732,30316,10299,53347,4964,37494,42458,270022
Castle Point,365,141,224,1,48,18,18,9,0,0,2,9,36,133,75,9,7,E07000069,2,37680,37682,23519,9525,44080,20546,97670,8335,23889,10443,42667,3873,31786,35659,213678
Central Bedfordshire,581,329,252,10,136,69,33,12,0,2,3,18,46,150,83,18,1,E06000056,15,108677,108692,81304,26069,139525,47133,294031,29628,76950,21837,128415,7672,90360,98032,629170
Charnwood,323,190,133,1,55,37,15,6,1,3,6,21,45,62,55,13,3,E07000130,25,69195,69220,47592,17209,84609,40358,189768,19101,43977,14244,77322,5465,58637,64102,400412
Chelmsford,414,177,237,4,83,43,11,3,0,2,1,10,20,137,81,16,3,E07000070,7,71240,71247,52442,18138,91339,32354,194273,20977,48474,14654,84105,4778,58430,63208,412833
Cheltenham,216,168,48,0,96,27,4,0,2,1,1,6,31,35,11,2,0,E07000078,71,53051,53122,36092,11506,62763,23327,133688,17513,30831,9316,57660,3637,39722,43359,287829
Cherwell,231,129,102,2,78,30,2,1,0,0,1,2,13,60,33,7,2,E07000177,28,58990,59018,46827,15063,78160,25109,165159,18690,41208,11458,71356,4261,49163,53424,348957
Cheshire East,909,632,277,8,240,158,74,19,3,0,14,43,73,141,111,22,3,E06000049,34,166202,166236,106863,38940,191253,79700,416756,38295,108118,37678,184091,14247,123065,137312,904395
Cheshire West and Chester,863,543,320,7,190,108,53,14,1,3,13,69,85,160,131,19,10,E06000050,53,147515,147568,95642,36206,170778,72377,375003,36780,94292,32553,163625,14259,108967,123226,809422
Chesterfield,207,107,100,1,40,32,5,0,1,1,1,13,13,34,54,12,0,E07000034,10,48483,48493,28593,12272,51909,24500,117274,11951,29809,10010,51770,6204,35622,41826,259363
Chichester,288,98,190,1,45,27,3,0,0,0,1,6,15,99,81,9,1,E07000225,11,53802,53813,27847,11384,56102,24935,120268,10058,29538,13651,53247,3822,39771,43593,270921
Chiltern,183,102,81,7,62,14,1,3,1,0,0,3,11,48,23,8,2,E07000005,12,38275,38287,24978,8854,46743,18300,98875,8067,27486,9282,44835,2334,30368,32702,214699
Chorley,226,180,46,1,59,29,15,0,0,0,10,28,38,24,15,6,1,E07000118,11,46754,46765,33167,11542,56645,23306,124660,11846,30986,10210,53042,4623,35705,40328,264795
Christchurch,99,41,58,0,11,7,3,0,0,0,3,7,10,25,22,8,3,E07000048,3,23129,23132,10786,5102,21420,11225,48533,3890,11650,6520,22060,2208,17116,19324,113049
City of London,11,5,6,1,2,1,0,0,0,0,0,0,1,3,3,0,0,E09000001,10,5503,5513,3245,360,4972,1335,9912,1734,2268,587,4589,190,2374,2564,22578
Colchester,351,153,198,1,64,32,7,2,0,0,2,35,10,103,75,17,3,E07000071,45,74493,74538,50589,18471,91385,37177,197622,22176,46426,14333,82935,5692,60279,65971,421066
Copeland,170,86,84,2,36,10,9,0,3,2,4,12,8,26,50,7,1,E07000029,8,32420,32428,20525,7984,35335,17367,81211,7420,20250,7374,35044,3760,23938,27698,176381
Corby,124,77,47,0,24,15,7,1,0,0,1,12,17,27,14,5,1,E07000150,0,26181,26181,20899,6145,33166,11883,72093,8988,17561,4705,31254,2697,21539,24236,153764
Cornwall,504,228,276,5,129,51,5,2,2,0,1,14,19,117,127,29,3,E06000052,136,258747,258883,123195,59778,259484,129374,571831,52271,141201,61318,254790,25907,178805,204712,1290216
Cotswold,133,90,43,1,43,8,2,0,0,0,2,18,16,29,10,4,0,E07000079,10,39934,39944,21933,8703,43206,16869,90711,6761,23748,9390,39899,2498,29067,31565,202119
County Durham,1349,1021,328,10,358,215,78,8,1,6,56,163,126,169,119,32,8,E06000047,16,233469,233485,143922,50595,247101,136695,578313,57736,142099,50340,250175,32568,171564,204132,1266105
Coventry,594,348,246,17,192,47,10,3,2,3,13,23,38,108,97,28,13,E08000026,192,132699,132891,84624,29800,153745,78126,346295,46038,79753,23827,149618,14765,109815,124580,753384
Craven,124,101,23,2,41,15,1,2,0,0,4,9,27,12,11,0,0,E07000163,6,27008,27014,14540,6139,28744,11312,60735,4541,15551,6453,26545,1975,19150,21125,135419
Crawley,200,84,116,4,43,17,3,1,0,0,3,8,5,59,48,9,0,E07000226,9,43455,43464,36489,11129,59495,17853,124966,18086,30372,6235,54693,3679,38279,41958,265081
Croydon,913,554,359,25,327,97,16,5,0,3,5,25,51,206,122,25,6,E09000008,257,147842,148099,105621,33112,190308,72740,401781,56135,104754,22870,183759,12734,128634,141368,875007
Dacorum,311,148,163,2,85,19,5,1,1,0,8,5,22,105,51,6,1,E07000096,6,61936,61942,44421,14422,77800,26610,163253,17780,42741,11236,71757,4576,49326,53902,350854
Darlington,244,178,66,0,47,29,8,0,1,1,20,40,32,34,23,7,2,E06000005,36,48608,48644,30337,11555,53443,23192,118527,12938,29571,9598,52107,4763,37199,41962,261240
Dartford,285,152,133,3,75,19,11,8,3,0,1,10,22,65,57,9,2,E07000107,11,41209,41220,31440,9765,53184,17304,111693,14129,28058,7031,49218,3314,33941,37255,239386
Daventry,136,95,41,2,38,17,12,2,1,0,3,9,11,31,5,4,1,E07000151,4,32614,32618,23617,7904,41546,15833,88900,7056,23461,7469,37986,2577,27454,30031,189535
Derby,707,426,281,7,178,65,35,5,3,0,12,67,54,137,120,19,5,E06000015,65,106444,106509,68979,26310,123691,55600,274580,34567,66695,18694,119956,11413,87060,98473,599518
Derbyshire Dales,167,98,69,1,39,20,8,1,2,0,4,11,12,27,35,6,1,E07000035,2,33479,33481,18153,8270,36541,15437,78401,5304,20178,8449,33931,2475,24683,27158,172971
Doncaster,799,594,205,1,101,76,37,15,2,4,52,198,108,116,65,18,6,E08000017,62,130757,130819,80998,33112,147770,73107,334987,36839,83033,26893,146765,16982,102983,119965,732536
Dover,339,191,148,1,44,31,29,12,1,0,2,13,58,87,37,21,3,E07000108,45,51408,51453,29124,11864,54478,26308,121774,11497,30114,11769,53380,5538,39477,45015,271622
Dudley,723,427,296,16,191,45,13,2,2,1,11,71,75,126,131,30,9,E08000027,36,133872,133908,86654,33987,155530,71196,347367,36902,86242,31319,154463,15918,111905,127823,763561
Ealing,741,459,282,31,290,47,12,2,1,4,8,28,36,165,82,28,7,E09000009,333,126854,127187,100465,25882,180615,72149,379111,66983,94916,19158,181057,12817,116712,129529,816884
East Cambridgeshire,97,54,43,0,32,11,3,1,0,0,1,2,4,25,17,0,1,E07000009,6,35741,35747,26726,8811,45920,14794,96251,10496,24532,7502,42530,2614,29487,32101,206629
East Devon,181,105,76,1,22,17,4,0,1,0,0,6,54,43,19,10,4,E07000040,28,63853,63881,30193,14837,62455,30327,137812,10152,33019,18010,61181,5285,47716,53001,315875
East Dorset,183,69,114,2,20,13,3,0,0,0,3,14,14,45,55,12,2,E07000050,9,30388,30397,18705,7183,34878,14262,75028,6252,18128,7689,32069,2266,24146,26412,163906
East Hampshire,196,92,104,4,43,27,3,0,0,0,2,3,10,43,50,10,1,E07000085,9,49090,49099,33561,11975,60953,22569,129058,10372,34003,11733,56108,3336,40113,43449,277714
East Hertfordshire,230,124,106,2,75,15,2,2,0,1,1,7,19,64,35,7,0,E07000242,5,58341,58346,43787,14070,75434,24659,157950,15900,43202,11119,70221,3678,46399,50077,336594
East Lindsey,319,236,83,0,28,11,3,4,0,2,8,70,110,39,27,15,2,E07000137,60,65048,65108,29753,14264,60716,39212,143945,10930,33998,19803,64731,8671,48140,56811,330595
East Northamptonshire,193,141,52,2,56,22,13,2,0,0,3,11,32,29,20,2,1,E06000011,48,149806,149854,90761,37856,168860,76734,374211,30352,93461,38316,162129,13877,116859,130736,816930
East Riding of Yorkshire,748,510,238,4,133,94,43,7,2,0,22,76,129,126,81,24,7,E07000193,9,49094,49103,33829,12135,58578,24481,129023,13649,32141,10259,56049,4377,40576,44953,279128
East Staffordshire,390,239,151,6,99,28,9,4,0,7,8,32,46,66,62,17,6,E07000244,9,49094,49103,33829,12135,58578,24481,129023,13649,32141,10259,56049,4377,40576,44953,279128
Eastbourne,316,84,232,3,31,22,4,1,3,3,0,3,14,143,75,9,5,E07000061,96,47373,47469,24700,10395,47926,22547,105568,11700,25074,9975,46749,4712,35193,39905,239691
Eastleigh,177,94,83,1,49,29,6,0,0,0,0,8,1,37,40,6,0,E07000086,7,53394,53401,40104,14551,69033,22549,146237,15099,36474,10859,62432,3817,44190,48007,310077
Eden,132,60,72,2,17,13,3,2,1,0,2,9,11,50,18,3,1,E07000030,3,25302,25305,13651,6191,28413,10322,58577,4611,14818,6251,25680,1875,18810,20685,130247
Elmbridge,266,126,140,4,69,17,11,4,0,0,0,14,7,87,48,4,1,E07000207,15,55716,55731,38467,10910,67522,24505,141404,14402,41114,10454,65970,3213,40555,43768,306873
Enfield,743,445,298,16,308,40,9,5,1,2,5,18,41,208,71,17,2,E09000010,168,121874,122042,77326,29134,153334,70690,330484,48948,87575,20185,156708,12840,109394,122234,731468
Epping Forest,383,222,161,2,142,24,5,1,0,1,4,11,32,112,40,8,1,E07000072,4,54405,54409,34722,12023,65304,25318,137367,14120,36515,11374,62009,4441,42077,46518,300303
Epsom and Ewell,219,106,113,2,58,12,5,0,0,1,4,4,20,60,43,7,3,E07000208,7,30531,30538,22696,7401,39844,14326,84267,8553,22095,6322,36970,2016,25355,27371,179146
Erewash,289,173,116,2,47,24,17,6,0,0,9,44,24,47,53,10,6,E07000036,11,50519,50530,34268,12446,59044,23565,129323,12874,32896,10572,56342,4874,39666,44540,280735
Exeter,114,64,50,5,31,2,1,0,0,0,0,10,15,33,11,5,1,E07000041,97,50619,50716,33015,13348,60870,28674,135907,16726,28936,8670,54332,4331,39301,43632,284587
Fareham,264,121,143,12,57,18,4,0,0,3,1,7,19,80,48,13,2,E07000087,4,47937,47941,34450,12324,59063,22135,127972,10780,32488,11716,54984,3489,39284,42773,273670
Fenland,207,107,100,1,29,33,9,0,0,1,0,8,26,51,36,13,0,E07000010,13,42074,42087,27304,9701,47829,21429,106263,10607,25554,10021,46182,4590,36042,40632,235164
Forest Heath,64,28,36,1,7,8,1,2,1,0,0,0,8,19,16,1,0,E07000201,9,27538,27547,20939,5705,33115,10938,70697,9627,15017,5049,29693,2035,21194,23229,151166
Forest of Dean,112,67,45,0,35,9,1,0,0,0,1,4,17,37,6,2,0,E07000080,7,36157,36164,21356,9008,41490,18851,90705,6997,22876,9326,39199,3535,29340,32875,198943
Fylde,254,176,78,0,43,29,16,4,1,1,17,23,42,30,37,8,3,E07000119,29,37328,37357,20222,7374,36447,18097,82140,6808,20722,9049,36579,3692,25591,29283,185359
Gateshead,446,341,105,1,150,65,10,1,0,7,37,51,19,50,43,11,1,E08000037,7,92582,92589,58988,21023,100184,47895,228090,27126,55998,18458,101582,12152,67807,79959,502220
Gedling,290,188,102,4,63,36,4,2,2,0,10,31,36,49,28,20,5,E07000173,5,50859,50864,33171,12940,59493,23791,129395,12831,32757,11054,56642,4657,39934,44591,281492
Gloucester,244,170,74,0,90,46,1,0,0,0,3,12,18,45,26,2,1,E07000081,68,52654,52722,38442,14303,65740,23202,141687,16740,34316,9366,60422,4616,43150,47766,302597
Gosport,156,71,85,5,37,9,1,0,1,1,0,4,13,46,31,5,3,E07000088,9,36668,36677,25813,8592,42981,16518,93904,10295,23102,7161,40558,3215,29915,33130,204269
Gravesham,295,150,145,0,57,14,7,8,2,2,6,15,39,85,41,17,2,E07000109,18,41681,41699,28617,10560,51903,21288,112368,12971,28255,8449,49675,4104,35572,39676,243418
Great Yarmouth,207,67,140,1,24,6,9,0,0,0,5,12,10,54,79,6,1,E07000145,27,44328,44355,22778,11433,46018,24216,104445,10578,24668,10753,45999,5330,35032,40362,235161
Greenwich,480,252,228,17,159,25,9,1,1,1,3,11,25,133,68,24,3,E09000011,208,102978,103186,71844,20697,132073,54649,279263,46783,71200,13521,131504,10420,83875,94295,608248
Guildford,220,102,118,1,52,23,8,2,1,1,0,7,7,59,47,12,0,E07000209,35,56045,56080,41942,12432,73649,28405,156428,17430,37914,10794,66138,3402,45445,48847,327493
Hackney,477,262,215,16,166,29,1,4,2,0,5,13,26,127,66,14,8,E09000012,655,101753,102408,68680,21394,133883,53540,277497,63690,65016,9589,138295,11183,75699,86882,605082
Halton,274,169,105,5,70,20,21,1,1,1,24,18,8,51,42,10,2,E06000006,6,54680,54686,37219,13102,63411,29297,143029,15780,35276,10288,61344,7732,39693,47425,306484
Hambleton,159,98,61,1,45,13,10,0,0,1,3,16,9,41,13,5,2,E07000164,8,39888,39896,25377,9843,47068,18187,100475,7705,24986,10414,43105,2972,30682,33654,217130
Hammersmith and Fulham,281,177,104,10,125,18,2,2,1,0,4,7,8,62,37,4,1,E09000013,512,81878,82390,66703,11073,107754,37798,223328,47759,50615,9029,107403,6531,53374,59905,473026
Harborough,151,94,57,2,28,18,3,5,0,1,4,14,19,25,26,4,2,E07000131,4,36097,36101,25343,9419,45791,16122,96675,7611,25807,8418,41836,2345,29261,31606,206218
Haringey,474,300,174,17,199,32,8,2,1,3,4,9,25,104,59,7,4,E09000014,643,103530,104173,70472,21601,138189,54873,285135,56411,73560,12440,142411,10650,85567,96217,627936
Harlow,188,91,97,2,55,8,1,2,0,1,2,5,15,61,29,5,2,E07000073,11,35708,35719,25261,8643,43847,14822,92573,11889,23136,5889,40914,3398,29380,32778,201984
Harrogate,284,208,76,3,82,55,37,10,2,1,3,9,6,20,36,18,2,E07000165,56,70342,70398,46509,16998,84662,29376,177545,16101,45959,15755,77815,4698,53313,58011,383769
Harrow,645,428,217,44,266,54,10,2,0,1,8,7,36,110,73,28,6,E09000015,53,86471,86524,65492,21423,123307,51444,261666,38827,65007,17293,121127,8289,86069,94358,563675
Hart,150,44,106,2,31,4,4,0,0,2,0,1,0,75,27,4,0,E07000089,4,36497,36501,29935,9156,49875,16212,105178,9417,28059,8402,45878,1891,30120,32011,219568
Hartlepool,250,168,82,2,56,36,13,1,0,0,8,21,31,65,11,5,1,E06000001,7,42095,42102,22635,10092,43513,23291,99531,10645,25487,8085,44217,5789,30117,35906,221756
Hastings,240,55,185,1,6,2,1,0,0,1,0,2,42,136,41,7,1,E07000062,92,42679,42771,22094,9770,44759,21277,97900,10729,25141,7810,43680,5159,32707,37866,222217
Havant,296,153,143,3,58,29,4,1,1,1,2,13,41,94,34,11,4,E07000090,9,52772,52781,32329,13080,59601,26646,131656,12262,32345,12780,57387,5172,43275,48447,290271
Havering,844,487,357,15,198,44,3,2,0,4,21,67,133,259,74,22,2,E09000016,34,99150,99184,67989,23479,121642,49486,262596,29088,65863,20440,115391,9464,84378,93842,571013
Herefordshire,293,153,140,1,44,60,12,2,0,1,6,6,21,87,46,4,3,E06000019,37,82512,82549,48094,20345,95114,38328,201881,18954,49486,20340,88780,7441,64494,71935,445145
Hertsmere,318,210,108,7,135,26,4,2,0,3,7,13,13,60,41,7,0,E07000098,10,40983,40993,28167,9622,52435,19076,109300,12328,28754,7890,48972,3208,32887,36095,235360
High Peak,238,167,71,1,65,17,14,4,3,3,18,28,14,33,29,7,2,E07000037,11,40760,40771,26377,10316,48560,18829,104082,9245,27298,8577,45120,3696,30980,34676,224649
Hillingdon,706,388,318,25,237,32,5,6,1,0,2,20,60,170,119,22,7,E09000017,28,103879,103907,80835,23706,141542,58384,304467,41411,75225,17948,134584,9404,96647,106051,649009
Hinckley and Bosworth,207,132,75,1,45,28,19,3,1,2,3,15,15,41,24,9,1,E07000132,4,46905,46909,33087,11408,56538,21178,122211,11652,30441,10531,52624,3812,37653,41465,263209
Horsham,225,135,90,4,52,41,10,3,1,1,4,5,14,39,40,8,3,E07000227,13,56503,56516,38028,13926,69240,25078,146272,12481,39134,13043,64658,3560,45684,49244,316690
Hounslow,569,283,286,23,151,28,4,3,2,3,5,26,38,175,86,19,6,E09000018,154,96738,96892,79763,20588,137867,52290,290508,51478,70356,14500,136334,9085,89064,98149,621883
Huntingdonshire,250,138,112,2,42,42,26,4,4,1,4,4,9,52,37,17,6,E07000011,7,71392,71399,56515,17780,93481,31865,199641,19699,49935,15357,84991,5239,60470,65709,421740
Hyndburn,211,124,87,2,26,20,4,4,1,4,13,25,25,50,28,9,0,E07000120,5,35977,35982,22029,7902,39118,19238,88287,10229,22178,7009,39416,4800,27610,32410,196095
Ipswich,319,163,156,0,77,37,5,4,0,0,0,4,36,89,44,21,2,E07000202,42,59259,59301,40014,16071,71423,25744,153252,20651,35554,9518,65723,5233,47800,53033,331309
Isle of Wight,255,99,156,3,30,37,7,0,1,3,1,7,10,80,63,12,1,E06000046,42,67464,67506,30353,15728,64218,35529,145828,12458,34969,16828,64255,6921,50514,57435,335024
Isles of Scilly,0,0,0,0,0,0,0,0,0,0,0,0,0,0,0,0,0,E06000053,1,1387,1388,653,220,1331,291,2495,248,615,268,1131,53,754,807,5821
Islington,325,158,167,7,110,20,2,1,1,0,0,8,9,96,60,7,4,E09000019,472,96400,96872,69852,13596,117488,47661,248597,53597,55527,9769,118893,9771,63382,73153,537515
Kensington and Chelsea,251,141,110,13,87,16,3,2,0,0,2,10,8,68,34,7,1,E09000020,574,84224,84798,51211,8583,87517,38563,185874,34610,47377,10787,92774,5357,45189,50546,413992
Kettering,198,119,79,2,32,33,22,8,0,0,0,4,18,39,27,11,2,E07000153,10,41452,41462,29305,9967,50012,17908,107192,11664,26973,8045,46682,3477,33973,37450,232786
King's Lynn and West Norfolk,389,183,206,2,78,45,9,0,0,0,3,7,39,92,99,14,1,E07000146,19,73943,73962,38946,15537,71704,34887,161074,15346,37858,17693,70897,7077,54681,61758,367691
Kingston upon Hull,611,388,223,2,60,82,42,9,1,1,24,87,80,117,70,26,10,E06000010,65,116430,116495,68035,28041,128130,62480,286686,37235,68225,17998,123458,14047,89572,103619,630258
Kingston upon Thames,305,171,134,8,84,30,1,1,1,1,1,14,30,86,34,6,8,E09000021,106,65092,65198,49530,13588,87348,32325,182791,25447,45956,10157,81560,4438,53598,58036,387585
Kirklees,869,641,228,4,186,80,22,11,9,10,57,139,123,102,92,25,9,E08000034,115,180992,181107,112199,44638,209514,97680,464031,54231,116802,34776,205809,19030,147731,166761,1017708
Knowsley,395,233,162,2,83,41,4,1,0,4,49,34,15,57,83,19,3,E08000011,3,62964,62967,38065,15173,69617,36538,159393,17383,41597,11823,70803,10631,43505,54136,347299
Lambeth,521,288,233,27,193,31,15,3,2,0,5,3,9,121,88,16,8,E09000022,702,131511,132213,110465,22530,183190,54540,370725,79778,86062,12398,178238,10729,97286,108015,789191
Lancaster,285,145,140,3,41,17,2,1,1,0,15,32,33,67,63,8,2,E07000121,76,60685,60761,34812,14852,67262,36034,152960,15013,34982,13117,63112,6215,46831,53046,329879
Leeds,1535,1135,400,10,390,204,50,13,4,11,74,231,148,141,159,80,20,E08000035,284,331535,331819,217528,73507,389929,170920,851884,111960,195836,56077,363873,31504,254023,285527,1833103
Leicester,810,466,344,5,140,85,41,28,5,13,14,63,72,138,143,51,12,E06000016,202,126501,126703,80780,33341,156425,85807,356353,54317,81559,18610,154486,14972,117551,132523,770065
Lewes,266,121,145,1,56,34,6,2,1,0,3,5,13,87,45,13,0,E07000063,21,43826,43847,23792,10626,48194,21075,103687,9000,26307,10799,46106,4066,34634,38700,232340
Lewisham,549,310,239,19,210,31,11,2,1,1,3,6,26,128,92,14,5,E09000023,342,117309,117651,82776,24079,151793,54462,313110,54917,82015,13471,150403,10755,93850,104605,685769
Lichfield,281,178,103,1,76,20,9,3,2,3,4,24,36,48,39,14,2,E07000194,8,43160,43168,28837,10890,51862,22895,114484,10255,28492,11855,50602,3959,35014,38973,247227
Lincoln,164,93,71,0,12,8,3,0,0,2,7,8,53,44,16,10,1,E07000138,25,42531,42556,26504,9926,49523,22054,108007,13918,22742,6630,43290,3907,34216,38123,231976
Liverpool,1280,914,366,15,413,88,18,3,6,16,150,147,58,157,163,36,10,E08000012,336,213813,214149,116778,44816,226270,130606,518470,71734,119000,33573,224307,31162,142132,173294,1130220
Luton,509,287,222,10,133,38,19,3,1,0,6,26,51,129,69,19,5,E06000032,88,75926,76014,53271,18407,100272,44936,216886,34766,52469,12522,99757,7571,73300,80871,473528
Maidstone,398,183,215,0,62,34,10,2,2,0,1,8,64,153,58,4,0,E07000110,43,65483,65526,46737,16283,82528,30703,176251,18809,43797,14100,76706,5323,54384,59707,378190
Maldon,139,43,96,0,23,7,2,0,1,0,0,4,6,62,29,4,1,E07000074,1,27209,27210,16765,6640,31856,13550,68811,5286,17998,6947,30231,2260,21961,24221,150473
Malvern Hills,130,59,71,1,33,8,3,1,0,0,0,6,7,42,24,5,0,E07000235,13,33676,33689,18038,7704,36261,17251,79254,5798,20028,9193,35019,2939,26171,29110,177072
Manchester,913,634,279,5,238,102,23,15,5,9,54,105,78,120,119,35,5,E08000003,286,213243,213529,128930,41535,243224,139708,553397,100016,117896,24415,242327,27014,159452,186466,1195719
Mansfield,295,133,162,2,43,12,13,1,2,0,3,33,24,85,54,19,4,E07000174,11,46848,46859,29832,11627,52392,24763,118614,13058,29598,9571,52227,6476,35895,42371,260071
Medway,729,370,359,5,109,47,14,5,3,4,1,41,141,241,91,22,5,E06000035,62,110045,110107,77912,27137,137954,56204,299207,34533,73752,20551,128836,10388,95679,106067,644217
Melton,91,63,28,2,16,6,0,0,1,3,1,13,21,10,12,6,0,E07000133,6,22179,22185,15481,5636,27422,9533,58072,5088,14915,4951,24954,1449,17892,19341,124552
Mendip,169,79,90,0,14,9,4,0,0,2,2,5,43,43,41,6,0,E07000187,14,48661,48675,28252,12726,56462,22191,119631,10098,30528,10950,51576,4137,38270,42407,262289
Merton,430,249,181,12,142,30,9,2,1,0,3,9,41,120,43,16,2,E09000024,94,80825,80919,65877,16484,112038,37560,231959,40626,57869,11784,110279,5930,67098,73028,496185
Mid Devon,69,41,28,0,12,4,1,1,0,1,2,2,18,18,6,3,1,E07000042,6,33966,33972,20163,8789,40218,15629,84799,7554,21433,8464,37451,2785,27554,30339,186561
Mid Suffolk,177,101,76,1,32,29,12,2,0,0,0,3,22,45,26,3,2,E07000203,5,41913,41918,27013,10977,50607,19466,108063,9051,27116,10600,46767,3020,34155,37175,233923
Mid Sussex,319,188,131,4,96,50,2,2,0,2,0,13,19,68,46,15,2,E07000228,13,58699,58712,42302,15173,75025,25227,157727,15372,40957,12708,69037,3864,47524,51388,336864
Middlesbrough,365,241,124,2,130,50,12,1,1,1,12,21,11,57,44,20,3,E06000002,42,59914,59956,31301,15063,63582,36969,146915,17944,36021,10736,64701,8001,45295,53296,324868
Milton Keynes,501,261,240,10,139,28,7,3,1,0,0,20,53,154,69,17,0,E06000042,13,101999,102012,84004,23644,137717,43668,289033,40289,72166,15353,127808,7955,86778,94733,613586
Mole Valley,239,118,121,6,61,27,8,0,0,0,0,4,12,56,49,14,2,E07000210,7,36964,36971,23808,8418,44170,16608,93004,7993,24830,8791,41614,2437,28801,31238,202827
New Forest,303,149,154,2,72,40,6,2,0,1,3,13,10,77,59,14,4,E07000091,14,80272,80286,45549,19709,86776,38022,190056,15172,46407,21288,82867,6715,63302,70017,423226
Newark and Sherwood,223,135,88,1,49,21,5,0,1,0,5,25,28,37,37,12,2,E07000175,5,50931,50936,31947,12686,57971,26174,128778,11337,32711,11897,55945,5246,39671,44917,280576
Newcastle upon Tyne,493,379,114,6,129,68,21,3,4,8,24,63,53,64,37,10,3,E08000021,50,121711,121761,69811,25835,133848,79016,308510,40493,68164,19137,127794,14793,89096,103889,661954
Newcastle-under-Lyme,350,236,114,2,72,37,16,4,1,1,7,36,60,58,40,14,2,E07000195,16,54204,54220,34876,12736,61568,30767,139947,13473,33858,11944,59275,6312,42716,49028,302470
Newham,745,421,324,28,229,30,7,4,1,3,13,17,89,217,80,23,4,E09000025,200,103012,103212,70712,26408,153761,75197,326078,72098,76696,11366,160160,12763,106549,119312,708762
North Devon,55,41,14,0,21,3,0,0,0,0,0,4,13,8,6,0,0,E07000043,45,44379,44424,22505,11045,47119,20388,101057,8926,24563,10799,44288,4064,31704,35768,225537
North Dorset,83,27,56,0,15,5,1,0,0,0,0,1,5,32,21,3,0,E07000050,9,30388,30397,18705,7183,34878,14262,75028,6252,18128,7689,32069,2266,24146,26412,163906
North East Derbyshire,272,187,85,1,73,48,11,2,0,1,8,18,25,38,34,12,1,E07000038,1,44049,44050,27073,11679,49919,23541,112212,9476,28124,11607,49207,5319,33926,39245,244714
North East Lincolnshire,252,197,55,2,26,6,0,0,0,0,11,89,63,24,14,13,4,E06000012,22,72498,72520,42039,19086,79227,36596,176948,18598,43609,14593,76800,7507,55935,63442,389710
North Hertfordshire,298,113,185,2,52,34,6,2,0,0,2,4,11,105,62,16,2,E07000099,9,54953,54962,40147,12782,68564,22946,144439,15802,37891,10763,64456,3958,43360,47318,311175
North Kesteven,195,104,91,0,29,6,2,1,0,0,5,18,43,56,26,8,1,E07000139,3,47548,47551,32060,11437,55065,23551,122113,10342,30924,12322,53588,4198,37834,42032,265284
North Lincolnshire,278,203,75,0,44,40,7,1,0,1,4,46,60,49,18,3,5,E06000013,11,73617,73628,48278,18768,84668,37661,189375,18988,46906,16151,82045,7593,59883,67476,412524
North Norfolk,185,78,107,1,23,22,2,1,1,0,0,7,21,67,34,6,0,E07000147,9,53215,53224,21871,10606,45819,26634,104930,7929,23910,14667,46506,4839,38336,43175,247835
North Somerset,333,206,127,2,48,52,27,7,0,4,3,22,41,75,36,12,4,E06000024,90,91604,91694,55596,23117,102607,42745,224065,20911,56079,21792,98782,8276,70435,78711,493252
North Tyneside,431,260,171,3,74,64,6,4,1,1,15,44,48,65,71,30,5,E08000022,14,94514,94528,61349,21815,104242,43647,231053,25694,58103,17951,101748,10638,66955,77593,504922
North Warwickshire,150,116,34,3,46,16,12,2,2,1,2,11,21,19,9,5,1,E07000218,1,27032,27033,18982,6732,33151,13019,71884,6439,18351,6461,31251,2850,21604,24454,154622
North West Leicestershire,211,121,90,2,43,11,7,2,0,0,3,21,32,47,27,15,1,E07000134,2,40461,40463,28778,9845,48999,19557,107179,10016,27865,8935,46816,3733,33202,36935,231393
Northampton,531,339,192,1,117,94,34,10,3,4,6,19,51,94,65,21,12,E06000061,2,40461,40463,28778,9845,48999,19557,107179,10016,27865,8935,46816,3733,33202,36935,231393
Northumberland,700,448,252,3,137,90,26,4,0,8,50,59,71,131,93,22,6,E06000057,13,147995,148008,86380,34368,158268,74956,353972,31614,88184,34060,153858,15641,108458,124099,779937
Norwich,200,44,156,0,7,8,5,1,0,0,0,6,17,67,79,9,1,E07000148,64,63249,63313,37502,13516,68772,31930,151720,22929,31989,9147,64065,5862,46939,52801,331899
Nottingham,636,406,230,6,131,61,18,3,1,2,32,85,67,85,90,44,11,E06000018,134,131060,131194,72252,27605,142327,89745,331929,47825,72851,17303,137979,15063,103332,118395,719497
Nuneaton and Bedworth,274,196,78,8,66,40,21,12,0,1,0,18,30,43,24,10,1,E07000219,24,54143,54167,38428,13588,65173,26917,144106,15728,35185,11706,62619,6019,44255,50274,311166
Oadby and Wigston,161,106,55,0,35,13,12,0,0,0,3,10,33,31,17,7,0,E07000135,1,22480,22481,15570,6146,28119,12678,62513,5955,15090,5284,26329,2082,20568,22650,133973
Oldham,628,484,144,13,165,42,12,5,7,2,38,130,70,70,51,17,6,E08000004,14,92984,92998,58410,22171,106398,53367,240346,29164,60665,18084,107913,12179,74987,87166,528423
Oxford,175,82,93,1,52,10,3,1,0,0,1,2,12,62,26,5,0,E07000178,124,57093,57217,42867,12360,74923,43514,173664,27544,33351,8234,69129,4189,48201,52390,352400
Pendle,260,178,82,3,38,24,7,2,0,3,17,55,29,47,29,5,1,E07000122,3,39380,39383,23179,9036,42765,21675,96655,12014,23378,7622,43014,4921,30826,35747,214799
Peterborough,316,150,166,0,41,36,11,5,4,3,4,12,34,79,71,14,2,E06000031,23,76737,76760,56704,18654,95646,36672,207676,28791,49612,12640,91043,7425,68493,75918,451397
Plymouth,207,120,87,1,44,30,3,0,0,4,8,17,13,34,47,5,1,E06000026,186,112883,113069,69234,28356,127742,64044,289376,33947,66780,21781,122508,13012,85956,98968,623921
Poole,395,140,255,0,52,23,4,0,1,0,10,34,16,128,115,11,1,E06000029,48,66454,66502,42040,16215,75720,30671,164646,17376,40433,14475,72284,5841,51486,57327,360759
Portsmouth,355,155,200,11,66,16,3,1,1,3,3,17,34,111,60,24,5,E06000044,161,87930,88091,57743,20626,105834,47871,232074,30411,52975,13736,97122,7995,71443,79438,496725
Preston,311,229,82,2,53,48,16,3,1,4,22,42,38,30,30,16,6,E07000123,49,60288,60337,38229,14188,70509,33576,156502,19708,36596,9763,66067,6644,47840,54484,337390
Purbeck,68,24,44,0,5,5,1,0,0,0,2,9,2,16,23,4,1,E07000051,3,22126,22129,11568,5222,22400,9979,49169,3879,11788,5633,21300,1782,16148,17930,110528
Reading,267,182,85,0,105,39,8,0,1,1,9,10,9,46,30,3,6,E06000038,116,65435,65551,52054,13883,86329,30479,182745,30020,41163,8966,80149,4590,54913,59503,387948
Redbridge,816,464,352,24,225,44,4,1,0,7,29,46,84,246,80,19,7,E09000026,111,101237,101348,71627,23948,137776,61768,295119,47660,75067,16665,139392,10479,97595,108074,643933
Redcar and Cleveland,315,221,94,0,62,44,19,1,0,1,24,42,28,33,52,8,1,E06000003,21,61878,61899,33372,15322,63530,35647,147871,14576,36805,14282,65663,8184,45844,54028,329461
Redditch,172,96,76,1,33,16,5,1,0,0,0,12,28,35,29,11,1,E07000236,22,35349,35371,27383,8991,46220,16303,98897,11991,23273,6706,41970,3522,29354,32876,209114
Reigate and Banstead,399,219,180,6,121,34,9,0,0,1,3,16,29,84,85,6,5,E07000211,34,57019,57053,43619,13429,74614,24559,156221,17405,40333,10978,68716,3844,46908,50752,332742
Ribble Valley,145,75,70,0,14,7,4,0,0,1,14,20,15,46,18,4,2,E07000124,1,25015,25016,16105,6023,29672,11613,63413,4697,16643,6229,27569,1805,18376,20181,136179
Richmond upon Thames,295,174,121,8,106,20,3,3,1,0,1,10,22,74,30,15,2,E09000027,107,82375,82482,61511,14207,104090,33689,213497,28338,59409,12927,100674,4617,57088,61705,458358
Richmondshire,82,57,25,1,17,19,7,1,0,0,0,4,8,13,7,4,1,E07000166,1,22796,22797,17121,5217,29017,9635,60990,5131,13426,4990,23547,1523,17383,18906,126240
Rochdale,600,463,137,10,130,41,24,5,7,4,39,133,70,54,46,24,13,E08000005,12,89954,89966,55604,20101,101003,51739,228447,27229,57970,16502,101701,12453,70158,82611,502725
Rochford,268,124,144,3,37,30,9,6,1,1,1,7,29,77,45,20,2,E07000075,2,34442,34444,23556,9179,42804,17621,93160,7842,24017,8779,40638,2816,29085,31901,200143
Rossendale,166,99,67,0,24,23,2,1,0,1,12,22,14,34,22,11,0,E07000125,5,30840,30845,20067,6794,35186,14889,76936,7956,19871,5738,33565,3475,22508,25983,167329
Rother,349,119,230,2,19,22,6,2,1,0,0,12,55,170,54,5,1,E07000064,19,43997,44016,18498,8685,39859,23002,90044,6448,22168,12108,40724,4463,33152,37615,212399
Rotherham,745,570,175,2,171,79,45,19,2,2,25,106,119,92,53,25,5,E08000018,20,111998,112018,68860,28830,125899,62060,285649,29645,72598,24612,126855,15114,87237,102351,626873
Rugby,173,97,76,2,29,32,3,0,0,0,3,10,18,51,16,7,2,E07000220,18,43174,43192,32415,10096,53457,19302,115270,12504,28852,9340,50696,3508,35306,38814,247972
Runnymede,155,87,68,2,46,13,9,1,0,0,0,8,8,37,25,6,0,E07000212,19,34227,34246,24716,7221,42816,16977,91730,9456,22832,6542,38830,2371,27451,29822,194628
Rushcliffe,203,117,86,3,47,19,7,1,0,0,7,19,14,42,34,8,2,E07000176,10,47339,47349,32677,11753,58045,22710,125185,11266,32275,10469,54010,3468,36222,39690,266234
Rushmoor,219,89,130,2,45,26,2,1,0,0,0,2,11,66,53,11,0,E07000092,19,37639,37658,34397,9362,54145,15507,113411,14239,27803,6194,48236,2625,33340,35965,235270
Rutland,65,32,33,0,7,11,2,1,0,0,0,9,2,11,18,4,0,E06000017,3,16066,16069,10314,3847,18758,8294,41213,3156,9572,4190,16918,1008,12718,13726,87926
Ryedale,67,44,23,1,17,8,5,0,0,0,0,7,6,15,5,2,1,E07000167,0,24743,24743,12760,5773,26644,10937,56114,4168,14041,6399,24608,1846,18476,20322,125787
Salford,619,513,106,19,221,55,14,4,1,18,35,83,63,45,49,9,3,E08000006,138,108469,108607,67966,21676,118130,54987,262759,37404,61325,17336,116065,13741,75685,89426,576857
Sandwell,963,559,404,17,219,76,25,4,4,7,23,88,96,184,176,40,4,E08000028,43,127029,127072,81339,29779,146653,72855,330626,44173,82703,24338,151214,18171,107081,125252,734164
Scarborough,188,147,41,0,47,25,3,2,0,1,8,31,30,25,13,2,1,E07000168,86,56357,56443,24346,12834,52245,27148,116573,9978,27918,13177,51073,5712,38721,44433,268522
Sedgemoor,177,91,86,2,32,22,6,0,1,0,1,16,11,39,36,8,3,E07000188,17,50862,50879,30108,13097,57966,24937,126108,11035,31269,12382,54686,4994,40291,45285,276958
Sefton,781,497,284,9,187,50,16,6,5,10,63,104,47,122,121,36,5,E08000014,158,123850,124008,71019,29799,133012,65185,299015,28107,75066,28391,131564,15549,89115,104664,659251
Selby,119,74,45,1,20,17,3,1,0,0,1,16,15,24,17,4,0,E07000169,4,36283,36287,26298,9293,45720,16111,97422,8746,25482,7671,41899,3008,28624,31632,207240
Sevenoaks,275,140,135,2,65,18,5,8,2,1,1,10,28,83,39,12,1,E07000111,7,48369,48376,31826,11527,58707,23391,125451,11464,33139,11241,55844,3569,38344,41913,271584
Sheffield,1204,860,344,4,308,193,34,10,5,14,37,152,103,172,116,42,14,E08000019,163,236648,236811,140933,56868,270239,140765,608805,74031,142579,44304,260914,26703,184343,211046,1317576
Shepway,364,201,163,0,41,36,39,13,4,1,1,10,56,108,37,15,3,E07000112,83,49485,49568,27386,11151,52387,25551,116475,10982,28646,11487,51115,5321,38999,44320,261478
Shropshire,539,323,216,11,86,91,35,7,0,3,12,39,39,90,102,22,2,E06000051,28,135544,135572,83106,34760,158983,64909,341758,30356,83982,33902,148240,11979,106909,118888,744458
Slough,313,153,160,12,70,16,3,1,1,1,3,21,25,88,56,15,1,E06000039,43,51738,51781,43610,11886,73819,26639,155954,27533,38281,6596,72410,4906,50464,55370,335515
Solihull,550,353,197,2,190,54,3,2,1,3,12,40,46,85,91,18,3,E08000029,9,88220,88229,59212,21701,105108,43252,229273,21257,58308,20362,99927,8241,70683,78924,496353
South Bucks,180,74,106,8,24,13,1,1,0,1,5,8,13,52,41,11,2,E07000246,9,88220,88229,59212,21701,105108,43252,229273,21257,58308,20362,99927,8241,70683,78924,496353
South Cambridgeshire,182,62,120,2,31,14,5,0,0,1,0,2,7,44,57,13,6,E07000012,14,61710,61724,48499,15597,82079,25700,171875,17188,44256,13088,74532,3739,50147,53886,362017
South Derbyshire,238,165,73,4,60,29,7,2,1,2,7,25,28,46,18,8,1,E07000039,2,40376,40378,29738,10279,50358,19092,109467,11249,28175,8111,47535,3647,32550,36197,233577
South Gloucestershire,390,252,138,4,96,50,11,2,1,0,3,33,52,56,66,15,1,E06000025,17,109967,109984,82489,31453,143198,49270,306410,31136,76154,23880,131170,8556,91675,100231,647795
South Hams,45,19,26,1,7,3,0,0,0,0,2,3,3,19,6,1,0,E07000044,6,43232,43238,18979,9180,41639,18978,88776,6460,22327,10466,39253,3156,28574,31730,202997
South Holland,177,103,74,1,22,20,9,1,1,0,5,23,21,29,31,11,3,E07000140,11,38650,38661,25724,8432,44276,19644,98076,9353,23841,10169,43363,4167,33149,37316,217416
South Kesteven,271,131,140,0,32,19,13,1,1,1,4,18,42,72,52,16,0,E07000141,6,59524,59530,40051,14579,70273,27046,151949,13829,38694,13727,66250,5005,46999,52004,329733
South Lakeland,264,200,64,8,99,26,8,0,0,0,13,18,28,32,25,7,0,E07000031,12,53410,53422,26863,12015,53396,22435,114709,9019,28071,13069,50159,3701,36385,40086,258376
South Norfolk,217,85,132,0,24,19,4,2,2,1,1,5,27,68,55,9,0,E07000149,1,54616,54617,33553,14032,63158,26179,136922,11871,34400,14067,60338,4297,44400,48697,300574
South Northamptonshire,129,89,40,1,32,14,6,2,0,0,2,11,21,21,16,2,1,E07000155,3,36041,36044,27039,9004,47449,14872,98364,7861,26848,8065,42774,2247,29703,31950,209132
South Oxfordshire,204,132,72,3,59,41,4,1,1,1,4,3,15,48,21,3,0,E07000179,10,56634,56644,41976,13591,72820,24072,152459,14130,39792,12984,66906,3517,44779,48296,324305
South Ribble,225,153,72,1,43,26,17,2,0,2,9,17,36,24,40,6,2,E07000126,4,47698,47702,35168,11969,58577,21881,127595,12388,31545,10641,54574,4473,37211,41684,271555
South Somerset,162,102,60,1,29,17,7,1,0,0,0,12,35,33,19,7,1,E07000189,12,73363,73375,44645,18305,82390,33400,178740,15563,42817,17904,76284,6115,57906,64021,392420
South Staffordshire,251,142,109,2,65,15,7,3,0,1,3,20,26,54,41,12,2,E07000196,3,45618,45621,30995,12224,56418,24300,123937,9541,31133,12626,53300,4435,38390,42825,265683
South Tyneside,448,300,148,3,77,66,7,3,0,11,27,24,82,85,39,21,3,E08000023,3,69690,69693,40838,15480,72645,36336,165299,17173,41794,13512,72479,9394,48861,58255,365726
Southampton,342,171,171,6,87,44,11,2,0,0,5,4,12,89,66,11,5,E06000045,207,100389,100596,68082,22856,123193,57008,271139,39934,57594,15294,112822,9223,82880,92103,576660
Southend-on-Sea,607,262,345,5,103,49,22,12,3,0,1,11,56,219,90,31,5,E06000033,134,78469,78603,47972,17949,88324,36683,190928,22826,48762,15014,86602,7778,60929,68707,424840
Southwark,419,255,164,28,165,37,5,2,3,0,0,3,12,92,45,18,9,E09000028,380,122885,123265,94675,22225,163859,60692,341451,67376,83866,11825,163067,10544,90004,100548,728331
Spelthorne,204,107,97,1,55,20,4,6,0,1,1,8,11,56,35,4,2,E07000213,18,40869,40887,32475,9279,52767,17149,111670,12453,28295,8470,49218,3085,34239,37324,239099
St Albans,320,173,147,0,91,20,6,10,4,2,3,14,23,87,48,10,2,E07000240,24,57867,57891,42999,13476,74553,25310,156338,17333,42741,10966,71040,3521,44813,48334,333603
St Edmundsbury,116,67,49,2,24,23,3,2,0,1,1,2,9,34,11,4,0,E07000204,12,47127,47139,34373,12418,59324,21644,127759,13019,29824,11200,54043,3695,39656,43351,272292
St. Helens,503,286,217,0,126,53,5,2,3,1,33,46,17,82,99,32,4,E08000013,13,79219,79232,49968,18169,86121,43463,197721,20182,49144,17501,86827,11364,55983,67347,431127
Stafford,320,217,103,0,58,39,11,1,0,0,12,33,63,72,25,5,1,E07000197,33,57477,57510,38948,14101,68274,29023,150346,13659,36790,13794,64243,5118,46574,51692,323791
Staffordshire Moorlands,268,171,97,3,31,24,10,6,0,0,4,28,65,55,31,7,4,E07000198,2,43583,43585,27432,10527,49988,22097,110044,9023,27725,11257,48005,4420,34050,38470,240104
Stevenage,153,72,81,0,39,11,3,0,1,0,1,3,14,40,27,12,2,E07000243,7,35562,35569,27053,8729,46140,14848,96770,11734,24544,5962,42240,2984,29953,32937,207516
Stockport,654,471,183,10,197,100,26,9,7,4,23,49,46,77,66,32,8,E08000007,48,125762,125810,83049,29946,146296,59014,318305,32948,81615,26345,140908,12505,94251,106756,691779
Stockton-on-Tees,438,317,121,3,50,59,25,4,2,3,25,63,83,75,32,9,5,E06000004,27,82210,82237,52927,22070,96259,44395,215651,23478,53541,15927,92946,9296,64282,73578,464412
Stoke-on-Trent,716,454,262,4,78,76,19,7,3,1,11,91,164,143,81,32,6,E06000021,35,111830,111865,67097,24732,119743,63065,274637,33815,66464,20777,121056,15356,86311,101667,609225
Stratford-on-Avon,270,199,71,3,98,50,4,1,0,0,11,8,24,46,19,5,1,E07000221,9,54772,54781,33817,12651,63253,24475,134196,10812,34286,14202,59300,4049,41966,46015,294292
Stroud,173,133,40,3,62,18,2,0,0,0,0,19,29,22,13,5,0,E07000082,14,49921,49935,31910,12899,59980,21975,126764,10287,33158,11641,55086,3783,39711,43494,275279
Suffolk Coastal,253,119,134,0,55,23,9,0,0,0,1,4,27,64,50,15,5,E07000205,24,58306,58330,31974,14036,61006,27244,134260,10189,33650,14563,58402,4427,44087,48514,299506
Sunderland,775,575,200,8,227,73,7,2,1,8,75,105,69,90,89,19,2,E08000024,63,123304,123367,75899,29186,135467,70085,310637,32550,77568,24835,134953,18155,90557,108712,677669
Surrey Heath,228,90,138,2,39,33,7,0,0,0,0,3,6,89,41,8,0,E07000214,8,34725,34733,27645,8500,47016,15549,98710,9391,26233,7597,43221,2148,28683,30831,207495
Sutton,455,221,234,8,123,28,9,1,0,0,0,11,41,135,76,21,2,E09000029,72,79624,79696,60111,18502,103995,34715,217323,27390,57104,13669,98163,6072,67563,73635,468817
Swale,401,221,180,2,62,34,13,3,0,1,7,41,58,114,51,13,2,E07000113,23,57966,57989,37613,13844,67913,30694,150064,15441,37330,12592,65363,6008,48719,54727,328143
Swindon,317,194,123,1,93,49,11,1,3,5,3,11,17,67,46,5,5,E06000030,40,91088,91128,71912,22137,117039,37041,248129,30159,63234,15071,108464,7556,73591,81147,528868
Tameside,641,508,133,10,149,69,44,13,13,34,54,81,41,62,40,24,7,E08000008,32,99114,99146,65546,21377,111016,50443,248382,27864,62964,18906,109734,12492,73918,86410,543672
Tamworth,193,112,81,1,42,8,9,4,2,3,3,25,15,41,33,6,1,E07000199,3,32257,32260,24514,8566,41188,15645,89913,10012,21839,6464,38315,3399,27064,30463,190951
Tandridge,210,100,110,2,47,30,9,0,0,0,0,1,11,54,51,5,0,E07000215,8,34710,34718,24205,8047,43692,15765,91709,8343,24149,7803,40295,2403,28514,30917,197639
Taunton Deane,181,46,135,0,20,9,3,0,1,0,0,5,8,69,58,6,2,E07000190,38,49182,49220,30983,12872,56832,22089,122776,11517,29621,10714,51852,4225,38014,42239,266087
Teignbridge,105,48,57,1,22,5,2,0,0,0,2,9,7,31,22,3,1,E07000045,39,57681,57720,30983,14300,61845,27626,134754,10693,33243,14584,58520,5268,43342,48610,299604
Telford and Wrekin,242,129,113,2,48,32,5,1,0,0,5,12,24,52,43,16,2,E06000020,7,68707,68714,50567,16530,84947,37332,189376,21125,46926,13835,81886,8023,57198,65221,405197
Tendring,576,202,374,5,78,49,18,5,0,0,8,23,16,191,149,32,2,E07000076,29,66899,66928,29346,14148,59908,37142,140544,11130,33555,18599,63284,8048,49451,57499,328255
Test Valley,221,129,92,1,53,44,7,2,0,2,7,2,11,35,50,7,0,E07000093,5,49138,49143,36237,12473,62141,22511,133362,11227,34587,11551,57365,3457,40262,43719,283589
Tewkesbury,176,124,52,1,76,18,2,0,0,0,0,8,19,40,10,2,0,E07000083,2,37055,37057,24881,9008,43454,16231,93574,8328,23720,8783,40831,2703,29183,31886,203348
Thanet,448,230,218,0,81,37,11,12,4,2,1,22,60,136,66,10,6,E07000114,85,64913,64998,29937,13626,61272,33180,138015,14062,33910,14130,62102,7785,47109,54894,320009
Three Rivers,229,122,107,0,53,26,3,0,0,0,5,11,24,71,30,5,1,E07000102,4,36151,36155,25698,8425,46280,16160,96563,10057,25910,7272,43239,2672,29873,32545,208502
Thurrock,447,232,215,0,101,23,14,3,0,0,10,51,30,144,56,13,2,E06000034,11,63858,63869,48620,16370,84464,29660,179114,22952,45689,10696,79337,5888,54788,60676,382996
Tonbridge and Malling,244,109,135,4,28,27,11,2,0,0,0,2,35,94,32,7,2,E07000115,8,49964,49972,35663,12690,63039,23396,134788,12347,36150,10953,59450,3728,41475,45203,289413
Torbay,149,94,55,1,36,17,2,0,0,0,13,16,9,27,20,7,1,E06000027,114,63852,63966,29537,14782,61795,32205,138319,12675,33743,15351,61769,7625,45098,52723,316777
Torridge,44,29,15,0,14,4,0,0,0,0,0,4,7,8,4,3,0,E07000046,13,30685,30698,13948,7250,31158,15352,67708,5490,16694,8108,30292,3128,22242,25370,154068
Tower Hamlets,500,261,239,24,139,17,5,0,0,3,8,20,45,165,59,12,3,E09000030,312,105067,105379,78031,18852,137233,59319,293435,72602,58347,8094,139043,11228,83209,94437,632294
Trafford,471,344,127,10,115,58,24,6,3,3,20,66,39,44,53,22,8,E08000009,67,97062,97129,68201,22799,118064,44742,253806,28728,67627,18212,114567,9273,71694,80967,546469
Tunbridge Wells,209,116,93,0,30,21,21,3,3,0,1,3,34,66,21,2,4,E07000116,39,48883,48922,33121,11265,59986,22066,126438,13645,33784,9572,57001,3550,38656,42206,274567
Uttlesford,129,64,65,0,37,17,4,0,0,1,0,2,3,32,26,5,2,E07000077,0,32862,32862,22883,8306,42473,14613,88275,7666,24138,7236,39040,2067,26483,28550,188727
Vale of White Horse,187,133,54,0,88,24,5,0,0,1,0,1,14,35,16,3,0,E07000180,4,51016,51020,39197,12547,65710,21767,139221,13880,34492,11311,59683,3163,41117,44280,294204
Wakefield,802,597,205,4,197,83,36,8,2,6,22,116,123,90,75,35,5,E08000036,50,146312,146362,95559,35763,164768,76229,372319,39026,93641,30080,162747,19507,110920,130427,811855
Walsall,880,528,352,20,230,84,24,2,4,0,14,86,64,148,165,31,8,E08000030,42,110901,110943,67743,26934,126805,65169,286651,33807,71816,24524,130147,14968,94650,109618,637359
Waltham Forest,543,320,223,11,180,35,9,2,0,3,4,16,60,163,49,9,2,E09000031,185,98094,98279,69385,21889,135015,55963,282252,50512,72758,13268,136538,10053,91954,102007,619076
Wandsworth,447,239,208,29,135,28,1,3,1,0,7,10,25,127,68,10,3,E09000032,417,134202,134619,123965,18968,189789,53744,386466,88229,83120,14196,185545,8749,91935,100684,807314
Warrington,514,346,168,0,135,62,12,1,2,4,37,54,39,93,49,19,7,E06000007,8,87935,87943,63875,21782,107765,41696,235118,24189,59748,18026,101963,8466,66223,74689,499713
Warwick,242,136,106,1,60,25,10,3,0,0,0,7,30,60,35,7,4,E07000222,47,60380,60427,43062,13456,73309,29574,159401,18268,38147,11809,68224,4275,46720,50995,339047
Watford,237,144,93,0,87,14,7,5,0,2,8,8,13,58,28,5,2,E07000103,51,37353,37404,30477,8438,50770,15515,105200,16153,26017,5686,47856,2931,31453,34384,224844
Waveney,249,141,108,0,67,42,8,0,0,0,3,14,7,49,46,10,3,E07000206,33,54525,54558,26780,13463,53460,28417,122120,10987,29042,13922,53951,5829,41820,47649,278278
Waverley,300,159,141,3,70,47,7,3,0,0,0,9,20,80,53,8,0,E07000216,13,51532,51545,33014,11669,61649,23968,130300,11429,35167,11815,58411,3078,39777,42855,283111
Wealden,374,154,220,2,59,32,9,6,4,0,4,6,32,146,58,13,3,E07000065,14,65145,65159,36449,15676,74214,31665,158004,12068,40885,17427,70380,5198,52009,57207,350750
Wellingborough,151,88,63,1,30,23,5,3,1,1,1,9,14,30,26,5,2,E07000156,4,33073,33077,23367,7449,39247,15570,85633,9203,21316,6756,37275,2973,27907,30880,186865
Welwyn Hatfield,246,116,130,6,54,33,10,2,0,0,0,4,7,82,41,6,1,E07000241,6,45525,45531,31315,9939,57036,24478,122768,14660,28837,8040,51537,3431,37488,40919,260755
West Berkshire,223,148,75,5,90,26,1,1,1,0,4,4,16,39,24,11,1,E06000037,17,64586,64603,51084,15567,85401,26653,178705,17631,46908,12871,77410,3818,53069,56887,377605
West Devon,30,21,9,0,7,4,0,1,1,1,0,2,5,6,2,0,1,E07000047,8,24669,24677,12110,5918,26543,12398,56969,4362,14277,6597,25236,2120,18599,20719,127601
West Dorset,138,57,81,2,36,10,0,0,0,0,0,7,2,43,30,8,0,E07000052,10,49309,49319,23139,10923,47566,22793,104421,7347,25398,13023,45768,3878,35640,39518,239026
West Lancashire,261,200,61,3,74,30,6,3,1,5,19,36,23,23,29,9,0,E07000127,10,47963,47973,29658,11504,55680,25921,122763,10473,30913,11679,53065,5380,36226,41606,265407
West Lindsey,161,83,78,0,12,8,1,0,0,0,4,17,41,49,17,11,1,E07000142,2,40196,40198,24183,9855,44768,20763,99569,7902,25123,10257,43282,3790,32075,35865,218914
West Oxfordshire,179,123,56,1,72,31,5,1,0,0,1,3,9,30,23,2,1,E07000181,4,45576,45580,34599,10889,58506,17657,121651,11761,30492,10032,52285,2942,35438,38380,257896
West Somerset,32,17,15,1,5,4,1,0,1,0,0,1,4,6,9,0,0,E07000191,6,17565,17571,7290,3626,16118,8800,35834,2498,7901,5103,15502,1756,12620,14376,83283
Westminster,358,204,154,20,137,14,3,0,0,0,7,5,18,91,49,13,1,E09000033,522,117796,118318,72899,12606,120418,55087,261010,53090,62011,13070,128171,9263,65807,75070,582569
Weymouth and Portland,68,34,34,2,26,1,1,0,0,0,0,2,2,18,13,3,0,E07000053,17,30980,30997,16457,8174,32103,15768,72502,6513,17286,7107,30906,2952,23933,26885,161290
Wigan,907,695,212,3,192,104,24,9,1,0,79,181,102,122,59,24,7,E08000010,27,141492,141519,94703,32880,162781,73714,364078,39168,92512,30112,161792,18112,103934,122046,789435
Wiltshire,773,446,327,11,185,118,28,2,1,3,5,42,51,167,130,29,1,E06000054,55,201936,201991,143218,50806,250792,88803,533619,48128,134878,44729,227735,14974,160362,175336,1138681
Winchester,190,125,65,3,52,43,3,1,0,0,4,11,8,35,27,3,0,E07000094,16,49124,49140,32339,11434,60029,24466,128268,11464,32253,11041,54758,3135,38219,41354,273520
Windsor and Maidenhead,313,162,151,8,86,24,2,2,0,2,4,11,23,88,46,14,3,E06000040,15,60886,60901,46337,12727,77650,26597,163311,18173,42632,12303,73108,3872,46571,50443,347763
Wirral,896,562,334,12,261,90,34,11,4,7,48,62,33,177,132,23,2,E08000015,82,145611,145693,83696,34513,153240,77611,349060,34925,88270,31004,154199,18448,102085,120533,769485
Woking,186,98,88,0,36,24,8,2,0,1,2,8,17,42,36,8,2,E07000217,7,40645,40652,32336,8977,54052,17670,113035,14557,29609,7306,51472,2602,34291,36893,242052
Wokingham,267,183,84,4,85,33,7,0,2,1,8,14,29,49,31,4,0,E06000041,9,62465,62474,51260,15282,84912,27361,178815,17683,47722,12981,78386,3310,51808,55118,374793
Wolverhampton,735,394,341,35,176,48,16,4,1,2,22,38,52,177,130,32,2,E08000031,86,105739,105825,63981,24364,120402,59581,268328,34170,66983,20381,121534,13796,88168,101964,597651
Worcester,175,75,100,0,38,13,4,1,0,0,2,9,8,70,23,7,0,E07000237,36,43236,43272,30777,11000,53966,19416,115159,13924,27614,7669,49207,3780,34497,38277,245915
Worthing,208,86,122,1,38,27,3,2,0,2,3,7,3,55,51,14,2,E07000229,92,48219,48311,29536,11186,53630,20708,115060,12348,29368,9819,51535,4355,37777,42132,257038
Wychavon,248,142,106,2,73,17,8,3,0,2,2,13,22,56,39,8,3,E07000238,15,51915,51930,32863,12816,61260,24221,131160,10633,33087,13383,57103,4339,41641,45980,286173
Wycombe,326,131,195,5,55,27,4,4,0,0,7,7,22,104,67,23,1,E07000007,38,70049,70087,51724,16001,91315,32873,191913,21526,48676,14541,84743,4653,58721,63374,410117
Wyre,340,226,114,0,40,48,17,2,1,0,25,58,35,75,32,6,1,E07000128,27,49965,49992,26923,11298,51450,26213,115884,9622,28357,13726,51705,5944,36224,42168,259749
Wyre Forest,249,156,93,1,71,31,4,1,0,1,8,9,30,42,33,15,3,E07000239,19,44989,45008,27045,10994,49712,22619,110370,10302,26600,11520,48422,4548,34481,39029,242829
York,337,200,137,3,65,74,9,4,1,1,5,13,25,79,42,12,4,E06000014,70,86413,86483,57032,22487,104945,44844,229308,26226,51588,16787,94601,6369,67709,74078,484470
